9 9 9 9 9 9 9 9 9 9 9 9 9 9 9 9 9 9 9 9
10 10 10 10 10 10 10 10 10 10 9 9 9 9 9 9 9 9 9 9
9 9 9 9 9 9 9 9 9 9 10 10 10 10 9 9 9 9 9 9
9 9 9 9 9 9 9 9 9 9 10 10 10 10 9 9 9 9 9 9
9 9 9 9 9 9 9 9 9 9 10 10 10 10 9 9 9 9 9 9
9 9 9 9 9 9 9 9 9 9 10 10 10 10 9 9 9 9 9 9
9 9 9 9 9 9 9 9 9 9 10 10 10 10 9 9 9 9 9 9
9 9 9 9 9 10 10 10 10 10 10 10 9 9 9 9 9 9 9 9
9 9 9 9 9 10 9 9 9 9 9 9 9 9 9 9 9 9 9 9
9 9 9 9 9 10 9 9 9 9 9 9 9 9 9 9 9 9 9 9
9 9 9 9 9 10 9 9 9 9 9 9 9 9 9 9 9 9 9 9
9 9 9 9 9 10 9 9 9 9 9 9 9 9 9 9 9 9 9 9
9 9 9 9 9 10 9 9 9 9 9 9 9 9 9 9 9 9 9 9
9 9 9 9 9 10 10 10 10 10 10 10 10 9 9 9 9 9 9 9
9 9 9 9 9 9 9 9 9 9 9 9 10 9 9 9 9 9 9 9
9 9 9 9 9 9 9 9 9 9 9 9 10 9 9 9 9 9 9 9
9 9 9 9 9 9 9 9 9 9 9 9 10 9 9 9 9 9 9 9
7 7 7 7 7 7 7 7 7 7 7 7 7 7 7 7 7 7 7 7
0 0 0 0 0 0 0 0 0 0 0 0 0 0 0 0 0 0 0 0
0 8 0 0 0 0 0 0 0 0 0 0 0 0 0 0 0 0 0 0
0 0 0 0 0 0 0 0 0 0 0 0 0 0 0 0 0 8 0 0
0 0 0 0 0 0 0 0 0 0 0 0 0 0 0 0 0 0 0 0
0 0 0 0 0 0 0 0 0 0 0 0 0 0 0 0 0 0 0 0
0 0 0 0 0 0 0 0 0 0 0 0 0 0 0 0 0 0 0 0
0 0 0 0 0 0 0 0 0 0 0 0 0 0 0 0 0 0 0 0
0 0 0 0 0 0 0 0 0 0 0 0 0 0 0 0 0 0 0 0
0 0 0 0 8 0 0 0 0 0 0 0 0 0 0 0 0 0 0 0
0 0 0 0 0 0 0 0 0 0 0 0 0 0 0 0 0 0 0 0
0 0 0 0 0 0 0 0 0 0 0 0 0 8 0 0 0 0 0 0
0 0 0 0 0 0 0 0 0 0 0 0 0 0 0 0 0 0 0 0
0 0 0 0 0 0 0 0 0 0 0 0 0 0 0 0 0 0 0 0
0 0 0 0 0 0 0 0 0 0 0 0 0 0 0 0 0 0 0 0
1 1 1 1 1 1 1 1 1 1 1 1 1 1 1 1 1 1 1 1
2 2 2 2 2 2 2 2 2 2 2 2 2 2 2 2 2 2 2 2
2 2 2 2 2 2 2 2 2 2 2 2 2 2 2 2 2 2 2 2
2 2 2 2 2 2 2 2 2 2 2 2 2 2 2 2 2 2 2 2
2 2 2 2 2 2 2 2 2 2 2 2 2 2 2 2 2 2 2 2
2 2 2 2 2 2 2 2 2 2 2 2 2 2 2 2 2 2 2 2
2 2 2 2 2 2 2 2 2 2 2 2 2 2 2 2 2 2 2 2